const int mapSize = 10;
int givenMap[mapSize][mapSize] = {
    {0, 0, 0, 1, 0, 1, 0, 0, 0, 0},
    {1, 0, 0, 1, 0, 1, 0, 1, 1, 0},
    {0, 0, 0, 1, 0, 1, 0, 1, 0, 0},
    {0, 1, 0, 0, 0, 1, 0, 0, 0, 1},
    {0, 0, 1, 0, 0, 1, 1, 1, 0, 0},
    {0, 0, 1, 1, 0, 0, 0, 0, 0, 0},
    {0, 0, 1, 0, 0, 0, 0, 1, 1, 1},
    {0, 0, 1, 0, 0, 0, 0, 1, 1, 1},
    {0, 0, 1, 0, 0, 0, 0, 0, 0, 1},
    {0, 0, 1, 0, 0, 0, 0, 1, 0, 1}
};