const int mapSize = 7;
int givenMap[mapSize][mapSize] = {
    {1, 1, 0, 0, 1, 0, 0},
    {1, 0, 0, 0, 0, 0, 0},
    {0, 0, 1, 0, 0, 0, 0},
    {1, 0, 0, 0, 1, 0, 1},
    {0, 0, 1, 0, 0, 0, 0},
    {1, 0, 0, 1, 0, 0, 0},
    {0, 0, 0, 0, 0, 1, 0}
};